OOOOOOOOOOOOOOOOOOOOOOOO
OOOOOOOOOOOOOOOOOOOOOOOO
FGGHOOOOOOOOOOOOOOOOOOOO
TTTUDOOOOOOOOOOOOOOOOOOO
TTTUFGHOOOOOOOOOOOOOCOOO
TTTTTTUFGGHOOFGGGGGGGGGH
TTTTTTTTTTUFHTTTTTTTTTTT
TTTTTTTTTTTTTTTTTTTTTTTT