OOOOOOOOOOOOOOOOOOOOOOOO
OOOOOOOOFGGGGHOOOOOOOOOO
OOOOOOOOSTTTTUOOOOOOOOOO
OOOOOOOOSTTTTUOOOOOOOOOO
OOOOOOOOSTTTTUOOOOOOOOOO
OOOOOOOOSTTTTUOOOOOOOOOO
OOOOOOOOSTTTTUOOOOOOOOOO
OOOOOOOOSTTTTUOOOOOOOOOO
OOOOOOOOSTTTTUOOOOOOOOOO
OOOOOOOOSTTTTUOOOOOOOOOO
OOODOOOOSTTTTUOOOOOOCOOO
FGGGGGGGSTTTTUGGGGGGGGGH
TTTTTTTTTTTTTTTTTTTTTTTT
TTTTTTTTTTTTTTTTTTTTTTTT